{0, 0, 0, 0, 0, 0, 0, 0, 0, 0}
{9, 9, 9, 9, 9, 9, 9, 9, 9, 9}
{7, 7, 7, 7, 7, 7, 7, 7, 7, 7}
{6, 6, 6, 6, 6, 6, 6, 6, 6, 6}
{5, 5, 5, 5, 5, 5, 5, 5, 5, 5}
{4, 4, 4, 4, 4, 4, 4, 4, 4, 4}
{3, 3, 3, 3, 3, 3, 3, 3, 3, 3}
{1, 1, 1, 1, 1, 1, 1, 1, 1, 1}
{0, 0, 0, 0, 0, 0, 0, 0, 0, 0}