{0, 8, 8, 8, 0, 0, 8, 8, 8, 0}
{0, 0, 0, 0, 8, 8, 0, 0, 0, 0}
{0, 0, 0, 0, 0, 0, 0, 0, 0, 0}
{0, 0, 0, 0, 0, 0, 0, 0, 0, 0}
{0, 0, 0, 4, 0, 0, 4, 0, 0, 0}
{0, 0, 0, 3, 0, 0, 3, 0, 0, 0}
{0, 0, 5, 2, 0, 0, 2, 5, 0, 0}
{1, 7, 6, 1, 0, 0, 1, 6, 7, 1}
{9, 9, 9, 9, 0, 0, 9, 9, 9, 9}
{0, 0, 0, 0, 0, 0, 0, 0, 0, 0}
{0, 0, 0, 0, 0, 0, 0, 0, 0, 0}
{0, 0, 0, 0, 0, 0, 0, 0, 0, 0}