{0, 0, 0, 0, 0, 0, 0, 0, 0, 0}
{0, 0, 4, 4, 4, 4, 4, 4, 0, 0}
{0, 0, 0, 9, 9, 9, 9, 0, 0, 0}
{0, 0, 9, 1, 7, 3, 1, 9, 0, 0}
{0, 0, 9, 5, 8, 8, 5, 9, 0, 0}
{0, 0, 9, 1, 7, 3, 1, 9, 0, 0}
{0, 0, 0, 9, 9, 9, 9, 0, 0, 0}
{0, 0, 0, 0, 0, 0, 0, 0, 0, 0}
{0, 0, 0, 0, 0, 0, 0, 0, 0, 0}
{0, 0, 0, 0, 0, 0, 0, 0, 0, 0}