{0, 0, 9, 8, 6, 8, 6, 9, 0, 0}
{0, 9, 4, 4, 5, 5, 4, 4, 9, 0}
{1, 2, 1, 2, 3, 3, 1, 2, 1, 2}
{0, 7, 9, 9, 9, 9, 9, 9, 7, 0}
{7, 7, 9, 9, 0, 0, 9, 9, 7, 7}
{9, 9, 0, 0, 0, 0, 0, 0, 9, 9}
{9, 9, 0, 0, 0, 0, 0, 0, 9, 9}
{0, 0, 0, 0, 0, 0, 0, 0, 0, 0}
{0, 0, 0, 0, 0, 0, 0, 0, 0, 0}
{0, 0, 0, 0, 0, 0, 0, 0, 0, 0}